{
  "map":[
    "111111100001111111",
    "111111000000111111",
    "110000000000000011",
    "100000000000000001",
    "000000000000000000",
    "000000000000000000",
    "000000000000000000",
    "000000000000000000",
    "100000000000000001",
    "110000000000000011",
    "111111000000111111",
    "111111100001111111"
  ],
  "materials":{
	"0":"cut_copper.json",
	"1":"default_wall.json",
        "2":"default_floor.json",
        "3":"default_gate.json"
  }
}