{
  "map":[
    "222222100001222222",
    "211111111111111112",
    "210000000000000012",
    "110000000000000011",
    "010000000000000010",
    "010000000000000010",
    "010000000000000010",
    "010000000000000010",
    "110000000000000011",
    "210000000000000012",
    "211111111111111112",
    "222222100001222222"
  ],
  "materials":{
	"0":"cut_copper.json",
	"1":"default_wall.json",
        "2":"default_floor.json"
  }
}