{
    "floor": [
        "0000000",
        "6560000",
        "0402045",
        "0321236",
        "0002040",
        "0323200",
        "0400340"
    ]
}